########
###   ##
#.$  $##
### $ ##
#.##$ ##
# # . ##
#$ .$ .#
#   .  #
########